AGO	io, kion oni faras
BENZINO	hejtaĵo por irigi aŭtomobilon
CERTA	malhezitema
DANA	rilata al la lando Danujo
DATO	tago, en rilato al la tempo
EFEKTIVA	reala
FABELO	historio pri mirigaj okazaĵoj
FERIO	libertempo
FIDI	plenkredi pri iu all io
FROSTI 	esti tre malvarma
FROTI	preme movi ion sur io alia
GLASO	ujo, el kiu oni drinkas
GLITI	facile movigi sur grasa supraĵo
HEJTI	varmigi ĉambron aŭ loĝejon
JAKO	vestaĵo por la supra parto de la korpo
KONSIDERI	zorge atenti ion
KAPTI	ekteni
KOSTO	pago necesa por ricevi ion
LITO	aĵo, sur kiu oni dormas
MARMORO	bela blanka ŝtono
MATERIALO	Krudaĵo necesa por plenumi ion
MEDITI	pripensadi
METROPOLO	granda urbego
MODERNA	nuntempa
MODESTA	malfiera
NU	vorto uzata por atentigi pri tio, kio sekvos
ORDINARA	kutima
PAŬZO	mallonga hezito
PUTO	subterejo, el kiu oni levprenas kutime akvon
PROVIZI	havigi necesaĵojn
RAKONTI	diri historion
RANO	vivantaĵeto, kiu loĝas sambone teron kaj akvon
RIPOZI	resti nenion faranta, eble dormanta
RULI	ĉirkaŭmove antaŭenigi ion
SOBRA	malebria
SPECIALA	intencata por unu celo
SUPOZI	kredi ion vera
ŜULTRO	plej supra trunkoparto
ŜVEBI	resti senmove pendanta, kvazaŭ fluge
TERURO	timego
URĜI	plirapidigi
VOJAĜI	iri aŭ veturi por atingi lokon ne proksiman
BINDO	eksteraĵo de libro
ĈIFI	malglatigi
DIO	supernatura reganta estaĵo
DIVERSA	malsameca
ESENCO	la ĉefa, plej necesa parto de io
FALSA	malvera
FRAPI	bateti
GLATA	priskribas ion, sur kiu mano facile glitas
INSTRUI	lernigi
KADRO	tio, per kiu oni ĉirkaŭigas, ekzemple fotografaĵon
KLARA	malkonfuza
KLASO	aro de lernantoj, kiuj lernas kune
LITERO	alfabeta signo
LUDI	fari ion por nura plezuro
MATURA	plenkreskinta, plenpova
ONKLO	frato de la patro aŭ patrino
PARDONI	malsevere trakti iun
PLEKTI	regule interkunigi laŭ longe, ekzemple harojn
PROBLEM	malfacila demando
PSALMO	speciala religia kanto
RELIGIO	kredo pri supernaturaj aferoj
ROBO	longs virina vesto
SERIOZA	zorge atent(ind)a
SPEGULO	glata, brila aĵo, per kiu oni povas vidi sin
ŜLOSI	fermi, ekzemple pordon, per speciala ilo
ŜPARI	atente reteni, ekzemple monon
TRUO	malplenaĵo en io
VIZITADI	ĉeesti; regule aliradi
ZONO	io, kion oni metas ĉirkaŭ la korpomezon
AMASO	multnombra aro
APARATO	ilaro por plenumi ion
APARTENI	esti ies posedaĵo
AVERTI	antaŭsciigi kaj atentigi
BARAKTI	forte movi sin por liberigi de io
BASTONO	longa, maldika peco de ligno
BLOVI	ekmovi la aeron
BOLi	varmigi je 100 gradoj centigradaj; forte malkvietigi
BORDO	apudakva tero
BORI	fari truon en io
DEKLIVO	klinita supraĵo
DIREKTO	la ĝusta vojo de unu loko al alia
DISTANCO	longeco inter du lokoj
DRIVI	sekvi la iron de la akvo
ELEMENTO	unu el la fundamentaj eroj de tutaĵo
FENESTRO	truo, kiun oni povas trarigardi, en muro de konstruaĵo
FIKSI	senmovigi ion
FERDEKO	supra promenejo de ŝipo
FIŜO	estaĵo, kiu vivas en akvo
FRAKASI	disrompi, dispecetigi
FURIOZA	freneze kolera
GAJA	rideme feliĉa
GENUO	mezo de kruro
GESTO	mansigno
GIGANTO	grandegulo
GRUPO	aro
HAVENO	apudborda ejo por ŝipoj
INTERMITA	interrompiĝanta
JUĜI	konsideri por decidi pri
ĴETI	rapide formovi de si ion tra la aero en alian lokon
KADAVRO	korpo de mortinto
KATASTROFO	subita malfeliĉega okazaĵo
KLIFO	marborda altaĵo
KOMPATI	senti kortuŝon pri ies malfeliĉo
KONSCII	scii tre klare
KUZO	filo de onklo aŭ onklino
LARMO	akvero el la okuloj
LIGNO	materialo de arboj
LUKTI	korpe batali kontraŭ iu aŭ io
MAGNETO	io, kio povas altiri
MANIERO	tiel, kiel oni faras ion
MARO	la akvo, kiu plejparte kovras la teron
MARŜI	iri piede
MESAĜO	parola aŭ skriba informo, sendita de unu persono al alia
MEVO	marbirdo
MIKSI	meti kune diversaĵojn
MONSTRO	nenormalega estaĵo
MUĜI	aŭdigi fortan bruon
MURO	la flanko de domo, ĉambro, ks
NORDO	la direkto de Afriko al Eŭropo
OKCIDENTO	la direkto al Eŭropo de Azio
OMBRO	mallumaĵo
ONDO	akvo, kiu leviĝas kaj refalas supraĵe de la maro
ORIENTO	la direkto al Azio de Eŭropo
PAFI	ĵeti ĵetaĵon per ĵetilo
PELT	irigi rapide antaŭen
PERMESI	konsenti, ke iu faru ion
PEZI	altiriĝi teren
PLUVO	akvo, kiu falas de la ĉielo
POPULARA	konata kaj amata de la popolo
PROMONTORO	alta terpeco antaŭeniĝanta en la maron
PROPRA	apartenanta nur al iu aŭ io
PUNKTO	malgranda ronda signo, per kiu oni finas propozicion
RAKETO	fajraĵo, kiun oni pafas en la aeron
REKTA	nedeflankiĝante alcela
REZIGNACIO	cedemo
RIFUĜI	foriri en iun lokon por eviti danĝeron
ROKO	ŝtonego
SAVI	liberigi iun el danĝero
SCENO	loko en teatro, kie aktoroj ludas
SENDI	foririgi iun
SERĈI	klopodi por trovi
SKOTA	rilata al Skotlando
SOVAĜA	krude fortega
ŜANCO	ebleco fari
ŜIPO	veturilo por veturi sur akvo
ŜIRI	rompi ion, forte tirante
ŜNURO	longa, forta tirilo
ŜTORMO	fortega, pluva ventego
TELEPATIO	senpera interkompreniĝo sen parolo kaj gestoj
TIPO	ekzemplo de specialaĵo
TIRI	movi ion aŭ iun al si
TOMBO	tertruo, en kiun oni metas kadavrojn
TRAFI	atingi per io
VANA	senrezulta, senutila
VANGO	vizaĝflanko
VIKTIMO	tiu, kiu estas oferita
AFIŜO	surmura presita sciigo
APERTI	malfermi
APOGI	subteni iun aŭ ion per io
BILETO	rajtiga papereto
DAMNI	kondamni (ofte uzata kiel sakro)
DEZERTA	senhoma
DOMACO	bedaŭrindaĵo
EKSPRESA	tre rapids
ENUI	malplezuri pro senintereso
FERO	malmola metalo
FOIRO	granda komerca kunveno
FUĜI	forkuri por sin savi
FUNKCII	plenumi sian taskon
GASTO	amika vizitanto
GIĈETO	fenestreto en muro, kie oni aĉetas, ekzemple biletojn
GLUO	fluaĵo, per kiu oni fiksas ion al io alia
GRUMBLI	murmuri malkontente
KABANO	iom kruda dometo
KAJERO	maldika libreto
KALVA	senhara
KASO	monkesto
KATO	hejmbesto kun belaj korpharoj
KOMBINI	kunmeti
KOOPERATIVO	societo kunaganta
KUBUTO	mezpunkto de la brako
KULTURI	prilabori la teron
KUPEO	parto de la vagono
LACA	bezonanta ripozon
LAGO	etendaĵo da akvo, ĉiuflanke ĉirkaŭata de tero
LINIO	kontinua streko
MENUO	listo de haveblaj manĝaĵoj
MIOPA	havanta neordinare mallongan vidpovon
NAJLO	larĝkapa metala pinto
NAZO	korpoparto, per kiu oni flaras
OLDA	maljuna, aŭ malnova
OPONI	kontraŭstari
PARKERE	per la memoro
PASAĜERO	veturanto
PINTO	pika ekstremo
PLORI	montri doloron per larmoj
PRINCIPO	fundamenta veraĵo
RANDO	ĉirkaŭa ekstremaĵo de io
RESTORACIO	loko, kie oni povas manĝi se oni pagas
SEKA	enhavanta neniom aŭ malmulte da akvo
SKRAPI	iom akre froti ion
STACIO	loko, kie haltas publikaj veturiloj
STREKI	desegni linion per unu movo de skribilo
STRIO	longa mallarĝa peco kun paralelaj randoj
STUDI	diligente esplori
SUFERI	senti doloron
SUFOKI	mortigi per senigo de aero
SUMO	ĉiuj partoj kune, kiel tuto
SURDA	nepovanta aŭdi
SVARMI	esti tre multnombra
TRAJNO	vagonaro kun lokomotivo
VAGONO	veturilo, kiun trenas lokomotivo
VITRO	malmola, travidebla, rompebla substanco
VULPO	flavruĝa hundosimila rabobesto
ADVOKATO	persono, kiu defendas alian en juĝejo
AERO	tio, kion oni spiras
ANIMO	spirito de la personeco
ARANĜI	meti laŭorde, ordigi
ASPIRI	fervore celi, forte deziri
ATESTI	pruvi, montri
ATMOSFERO	sentiĝo de la cirkonstancoj
BARBO	hararo sur la mentono
CITI	laŭvorte rediri aŭ reskribi
EKSPERIMENTO	kontrolata provo pruvi ion
ELOKVENTA	povanta facile kaj flue paroladi
EMBARASO	ĝena sento
ENTUZIASMO	fervorego
FERVORO	ardo por io
FESTO	speciale aranĝita plezurkunveno
FLUI	facile trapasi de unu loko al alia
FONDI	starigi organizon
FONTO	origino, deveno
GENIO	elstara talentego
GENTO	popoleto
HARMONIO	agrablaj samtempaj sonoj; do: agrabla kunestado
IDEALA	perfekteca
INSPIRI	estigi stimulan senton en ies spirito
INSTIGI	kuraĝigi ion, ke li faru ion
KATALOGO	ordigita listo
KLASIKA	tradicia
KODO	sistemo de senanimaj simboloj
KOLEGO	amika kunlaboranto
KOLEKTIVO	aro da personoj kunlaborantaj
KOMERCI	profesie vendi kaj aĉeti
KONCEPTO	abstrakta kaj ĝenerala ideo
KONGRESO	kunveno por diskuti komunan temon
KONTAKTO	interrilato
KORESPONDI	interinterŝanĝi leterojn
KREI	fari, estigi
KURACI	resanigi malsanulojn
LIGI	ĉirkaŭŝnuri, kunŝnuri
LITERATURO	tuto de la verkoj de unu kulturo
MIRAKLO	okazaĵo ne klarigebla laŭ la fizikaj leĝoj
MISTERO	io nekonata, nekomprenata
MORALO	konduto de la spirito
NASKI	estigi idon
OFICIRO	armea superulo
ORGANIZI	detale aranĝi ion
OVACIO	entuziasmegaj aplaŭdoj
PASTRO	religia funkciulo
PATRIOTO	homo, kiu arde amas sian patrolandon
PENTEKOSTO	kristana festo, al kiu ligiĝas la ideo peri miraklan interkornpreniĝon de diverslingvuloj
POEZIO	arto verki versaĵojn
PRETENDI	aserti sian rajton pri io
PROFITI	ricevi utilon aŭ gajnon de io
PROPAGANDO	disvastigado de informoj
PSIKOLOGIO	scienco pri is homa menso
REGNO	lando kiel politika tuto
RIMEDO	tio, kio servas por atingi celon
RIPETI	denove diri aŭ fari ion
RONDO	cirklo; societo
SALONO	ĉambrego
SCIENCO	sistema tutaĵo de konoj
SENTIMENTO	sentema animstato
SIGNIFO	figuro, kiu anstataŭas aŭ reprezentas abstraktaĵon
SOLENA	ceremonieca
SOLVI	trovi la respondon aŭ la rimedon
SONI	aŭdigi
SPECO	komunkarakteriza grupo
SPIRITO	mensa aŭ animeca tuto de la homo
TALENTO	aparta spirita kapablo
TEATRO	konstruo, en kiu oni prezentas spektaklojn
TEKNIKO	procedaro de arto aŭ medio
UNIKA	unusola
UNIVERSALA	tutmonda, ĉie estanta
VERKI	krei ion, plejofte libron, per arto aŭ scienco
AŬTORITATO	ordonpovo
BARBARO	necivilizita homo
BUTERO	grasaĵo farita el lakto
DEKLARI	publike sciigi
DILIGENTA	konstante kaj zorge laborema
DISCIPLINO	ordemo kaj obeemo
FORKO	ilo kun dentoj uzata por levi ion
FRITI	kuiri mangagon en graso
HAZARDO	neantaŭvidebla okazo
INTERPRETI	transklarigi
INVENTI	elpensi ion novan
KAFO	speco de trinkaĵo
KONDUTI	agi laŭ certa maniero
LERTA	tre kapabla facile fari ion
MASTRO	posedanto, ordonanto
NERVOZA	malpacienca
NESTO	konstruaĵo de birdoj
OFICO	okupo
PLUMO	tio, kio are kovras birdokorpojn (ankaŭ: skribilo)
PRELEGO	instrua parolado
RIPROĈI	malmilde mallaŭdi iun
SALTI	rapide levi sin de la tero
SUKERO	dolcaĵo, generale blanka
TERORO	terura kaj kruela regado
ADMONI	averti iun, ke li ne faru ion
AKRA	tranĉ- aŭ pik-kapabla
AKSO	limo, ĉirkaŭ kiu turniĝas korpo
AKTO	parto de dramo
AKUZI	aserti iun kulpa pri io
ANGULO	spaco inter du renkontaj surfacoj: do: nerimarkata loko
BAGATELO	afero neserioza, negrava
BEZONI	esti en stato, ke io mankas
BLINDA	nevidpova
BRANDO	forta alkoholaĵo
CERBO	pensorgano
DETALO	malgranda parto
DIAMANTO	malmola valorŝtono
DIFINI	precize klarigi la signifon de io
DRONI	morti, sufokiĝante en akvo
EGOISMO	memamo
EPOKO	jararo
ESPLORI	zorge peni por ekkoni ion
FILOZOFIO	scienco pri la vivprincipoj
FINGRO	ekstremaĵo de la mano
FUNDO	plej malsupra parto
GLOBO	sfera objekto
GRAVA	grandinflua
GUTO	globeto de fluaĵo
HONORARIO	pago por servo
INCITI	kolerigi
INTELEKTO	kapablo pensi kaj kompreni
INTIMA	profunde komunsenta kaj senĝena
JUSTA	laŭmerita
KAMARADO	amika kunulo
KAPABLA	povanta fari ion
KARAKTERO	individua trajtaro
KAŬZO	tio, pro kio io okazas
KELNERO	servisto en restoracio
KLIMATO	tutajo de la veteraj kondiĉoj
KONDAMNI	deklari iun kulpa
KONJEKTI	havi opinion pri io
KONTENTA	havanta ĉion, kion oni dezirus
KREVI	subite rompiĝi pro interna premo
KRIMO	ago kontraŭleĝa
KULPA	intence aŭ konscie plenuminta ion riproĉindan
LANGO	movebla karnaĵo en la buŝo
LAŬDI	esprimi favoran opinion
LECIONO	tio, kion oni lernigas
LIRO	speco de monero
MEDIKAMENTO	saniga rimedo
MENSOGI	diri malveron
OBJEKTO	io konceptebla aŭ perceptebla
PARENCO	membro de la sama familio
PENTI	senti bedaŭron
PEREI	tute neniiĝi
POSTENO	ofico
POZICIO	loko, sur kiu io estas
PUNI	kaŭzi al iu suferon kompense de ties malbonfaro
RABI	perforte forpreni ion, kio apartenas al alia
SANA	normale funkcianta
SANGO	ruĝa fluaĵo en la korpo
SITUACIO	tuto de 1a kondiĉoj kaj cirkonstancoj
SKUI	rapide movi tien kaj reen
SOCIO	tuto da homoj kunvivanta
STULTA	malsaĝa
UTILA	uzinda
VAKI	esti neokupata
VERSI	fluigi fluaĵon el ujo
VERVO	spirita fervoro
ADRESO	loko, kie iu loĝas
AKIRI	havigi al si
AMARA	maldolĉa
AMPLEKSO	grandeco
ANONIMA	sennoma
APLOMBO	granda memfido
BLONDA	helkolora
BRIDO	kaprimeno por ĉevalo
BRIDI (metafore)	kvietigi, malhelpi
CENTRO	meza punkto aŭ parto
CINDRO	brulrestaĵo
ĈESI	ne plu fari ion
DENSA	tre proksime metitaj
DENTO	elstaranta buŝosto
DESEGNI	per plumo aŭ krajono montri la trajtojn de io aŭ iu
DIABLO	malbona spirito
DUBI	esti malcerta
ERUDICIO	granda klero
FAKO	aparta dividaĵo aŭ branĉo
FANFARONI	sin mem laŭdi
FILOLOGO	sciencisto pri lingvoj
FINALO	fina parto
FLAGRI	intermite ekflami
FLAMO	hela brulanta fajrgaso
FORMALA	laŭregula, 1aŭleĝa
FORNO	fajrujo por hejti kaj kuiri
FUMO	vaporo de brulaĵo
GRADO	mezuro de io
ĜENTILA	bonmaniere afabla
HUMORO	animstato
INĜENIERO	sciencmetoda teĥnikisto
INSPEKTI	kontroli ies agadon
ĴURI	solene atesti
ĴURNALO	ĉiutaga gazeto
KANALO	artefarita rivero
KINO	teatro, kie oni montras filmojn
KOMO	interpunkcia signo (,)
KOMPAKTA	densa kaj nedisiĝema
KOMUNIKI	diskonigi
KONCERNI	esti la afero de iu
KONFESI	deklari ion malbonan pri si mem
KONFIDI	plenkrede transdoni
KONJUNKTURO	cirkonstancaro
KONKURSO	konkuro por premio
KONTINUA	seninterrompa
KOVERTO	kovrilo por letero
KREPUSKO	duonlumo matena aŭ vespera
KRITIKI	montri la mankojn de iu aŭ io
KRURO	korpoparto, per kiu oni marŝas
KUIRI	prepari mangaĵon
KURBA	malrekta
LOGARITMO	nombro de aritmetika progresio respondanta al alia nombro de geometria progresio
MANIERO	metodo de agado
MODULI	variigi la tonojn
MUŜO	doma insekto
NERVO	korpoparto, kiu transdonas impresojn al la cerbo
NOBLA	havanta altajn moralajn kvalitojn
NOMBRO	nedifinita kvanto
NOTI	skribi resumon
NUMERO	cifero
PASIO	arda deziro
PAVIMO	ŝtona tegaĵo de strato
PERSISTI	energie daŭri aŭ daŭrigi
PLACO	libera spaco en urbo
PLAĈI	kontentigi
PLANDO	suba parto de piedo
POEMO	versaĵo
POETO	versaĵisto
POLVO	sekaj eretoj de tero
PRECIZA	klare determinita
PREMIO	donaco al konkursgajninto
PROMESI	certigi, ke oni faros ion
PROPORCIO	rilato de partoj inter si
RAŬKA	sonanta skrape kaj malklare
REDAKTORO	persono, kiu estras gazeton
RENVERSI	faligi ion aŭ iun
RETO	truplena fadenplektaĵo
REZIGNI	definitive forlasi ion
ROMANO	longa proza f1kciaĵo
ROMANTIKO	literatura doktrino, kiu preferas fantazion al racio
RUZA	lerte trompa
SENCO	komprenebleco
SERVICO	manĝilaro
SEZONO	jarkvarono, laŭ vidpunkto de la normala vetero
SOMNAMBULO	persono, kiu marŝas dormante
SONĜO	dumdorma mensbildo
SORĈI	ĉarmegi
STATURO	korpalteco
STUMPO	mallonga restaĵo de io
SUĈI	alspiri al si
SABLONO	modelo, laŭ kiu oni eltranĉas objekton; (metafore): banalaĵo
ŜERCI	paroli neserioze, ridige
TERMINO	speciala vorto aŭ esprimo
TRAGEDIO	dramo kun malĝoja fino
TURNI	ĉirkaŭmovi ion
UNIVERSITATO	centro de supera studado
VETI	riski sumon en ludo
VETERO	stato de la atmosfero
ZIGZAGO	linio, iranta alterne laŭ kontraŭaj direktoj
BALANCI	movi tien kaj reen
BALANCIERO	radeto en horloĝo, kiu reguligas la moviĝon
BAROSKOPO	aparato uzata por mezuri gaspremon
BRAKO	korpoparto de la ŝultro ĝis la mano
CENTIMETRO (cm)	centono de metro
DETRUI	ruinigi, neniigi
DIAMETRO	mezuro trans cirklo tra la centro
DIFEKTI	kaŭzi malbonon al io
DILETANTO	persono, kiu okupiĝas nur supraĵe pri io
EKVATORO	imaga linio ĉirkaŭ la tero, meze inter la polusoj
EKZAMENI	detale esplori
ELEKTRO	unu formo de fizika energio
GARANTII	firme promesi ion
GLACIO	akvo solidigita per malvarmo
INFLUI	rezultigi agadon de iu aŭ io
KAZO	difinita aparta okazo
KILOMETRO (km)	milo da metroj
KONSERVI	zorgi, ke io ne difektiĝu aŭ perdiĝu
KONSISTI	havi kiel erojn
KONSTANTA	senŝanĝa, senĉesa
KONTROLI	detale esplori, oficiale ekzameni
KRONOMETRO	tre preciza horloĝo
KUDRI	kunigi per fadeno kaj speciala pinta ilo
KVALITO	grado de boneco
KVANTO	nombro da objektoj aŭ personoj
LAGRO	maŝina peco, kiu portas la akson de rado
LIKVA	flueca
LOKOMOTIVO	maŝino por tiri vagonojn sur fervojo
LUBRIKI	olei maŝinon
MAGNETO	ferpeco kun altira povo
MANIPULI	manuzi
MAŜINO	aparato, kiu produktas, transsendas aŭ utiligas forton
MATEMATIKO	scienco pri kalkulo
MEKANISMO	tuto de la pecoj de maŝino
MEMORI	konservi antaŭe ricevitajn ideojn
MERITI	esti inda je rekompenco
MEZURI	taksi kaj difini grandecon
MILIMETRO (mm)	dekono de centimetro
MINUTO	sesdekono de horo
MOTORO	maŝino, kiu produktas movon
NORMALA	ordinara, laŭkutima
OLEO	grasa fluidaĵo
PENETRI	eniĝi al io
PERIMETRO	linio ĉirkaŭ figuro
PIKI	enigi pinton en ion
PIVOTO	turnpunkto
PRUVI	montri, ke io estas vera
PUNKTO	preciza loko, kie io okazas
PURA	sendifekta
RADO	rondaĵo turniĝanta ĉirkaŭ akso
REGULA	ripetiĝanta post fiksita periodo
RELATIVA	pli-malplia
REVIZI	ekzameni kaj kontroli
RIPARI	rebonigi
RISORTO	elasta metala fadeno
SEKUNDO	sesdekono de minuto
SIGNALO	komunika signo
SOLIDA	firma, konfidinda
SPIRALO	rondiranta linio, kiu malproksimiĝas de sia centro
ŜIRMI	protekti ion por eviti difekton
ŜMIRI	froti per grasaĵo
ŜTALO	tre malmola metalo
VALORI	havi meriton, altan prezon
VARMA	sento produktata de brulo aŭ fajro
VITRINO	elmontra vitrujo
ABSTRAKTA	malkonkreta
AKCENTO	plilaŭtigo de voĉo
AMUZI	gajigi
ANTIKVA	malnovega
ARĤIVO	dokumentujo
ARKO	kurblinio
AVENTURO	neordinara kaj ne atendita okazaĵo
BANI	meti en akvon por ĝin lavi
BANALA	seninteresa, ĉar tre ordinara
BANKEDO	komuna manĝo
BARI	fermi vojon per io
BILDO	videbla similaĵo de io
BORDERI	start ĉe la rando de io
BRILIANTO	speco de diamanto
BUNTA	diverskolora
ĈERPI	elpreni, eltiri
DEDUKTI	fart konkludon per logiko
DIMENSIO	mezuro
DIVENI	supozi laŭ elpensado
DORSO	malantaŭo de la korpo
EKZEMPLERO	unuopa specimeno
ENIGMO	malfacile komprenebla afero
ETOSO	spirita atmosfero
FENDI	disigi laŭlonge ion
FENOMENO	malofta afero
FILMO	tio, sur kiu oni faras negativojn dum fotado
FLATI	trolaŭdi
FOTI	fari bildon sur filmon
FOTOGRAFO	homo, kiu fotas
FRONTO	antaŭa parto de objekto
FRUNTO	superokula parto de vizaĝo
GAPI	rigardadi kun larĝe malfermitaj okuloj
GLUTI	enstomakigi
GRAVURI	desegni sur metalo aŭ ŝtono
GRIMPI	pene supreniri
HAŬTO	natura korpokovro de la homo
HIPNOTO	arte kaŭzita dormo
IMPERIO	granda regno
INDIGO	malhelblua koloro
INDIKI	precize konigi ion
INKVIZITORO	rigora esploranto
INTENSA	tre energia
INUNDO	superakvego
JUGLANDO	speco de nukso
JUVELO	multekosta ŝtono
KARTO	kartonfolieto
KOFRO	granda kesto, ujego
KOLEKTI	iom post iom amasigi samspecajn objektojn
KOMIKA	ridiga, amuza
KOMPLIKI	malsimpligi
KONCENTRA	havanta komunan centron
KONFIRMI	plicertigi
KONSTERNI	konfuzi, maltrankviligi
KONVERSACIO	interparolado
KONVULSIO	fortega skuiĝo
KRONO	reĝa kapornamo
KURTENO	ŝtofa fenestrokovrilo
LANTERNO	lampego
LOGIKO	rezonanta pensmaniero
LUKSO	riĉa vivmaniero
MARKO	distingiga signo
MARŜI	paŝi
MEBLO	seĝo, tablo, lito, aŭ alia hejmobjekto
METALO	malmola substanco
MUZEO	domo, kie oni konservas malnovajn interesaĵojn
NAVIGI	marveturi
NUBO	densaĵo sur la ĉielo
ODORI	esti flarebla
OPERACIO	agmaniero
ORNAMI	plibeligi
PALACO	reĝa domego
PAŜTI	manĝigi bestojn sur kampo
PEJZAĜO	landvidaĵo
PERLO	juvela globeto
PIRATO	marrabisto
PLAFONO	plataĵo super ĉambro
PLANKO	tio, sur kiu oni paŝas en ĉambro
POŜTO	organizo por transporti leterojn
PROCESO	sinsekvo de fenomenoj
PSIĤO	tuto de la mensaj fortoj
RUBENO	ruĝa valorŝtono
SAFIRO	blua valorŝtono
SERIO	laŭorda sinsekvo
SKATOLO	ujo el ligno ail simila materialo
SPEKTAKLO	interesa vidaĵo
ŜPRUCI	rapide elflui
ŜTELI	preni ion, kio apartenas al alia
ŜVITI	eligi fluaĵon tra la haŭto
TEGMENTO	domsupraĵo
TENDO	provizora loĝejeto el tolo
TUFO	densa aro da maldikaĵoj
VALO	intermonto
VANDO	maldika mureto
VAPORO	gasa nubo
VETERANO	homo, kiu longe servadis ĉe io
VIGLA	vivoplena
VIOLO	floro kun karakteriza koloro
ADRIA MARO	la maro kuŝanta inter Italujo kaj Jugoslavio
AŬTOMATO	io funkcianta sen homa direktado
BOATO	ŝipeto
BRAVA	preta sentime fari sian devon
ĈAPO	plata kapvesto
ĈEMIZO	subvesto
DALMATIO	regiono de Jugoslavio
DANCI	ritme movigi laŭ muzika takto
EĤO	ripetiĝo de sono
EKSTREMA	plej malproksima
ETENDI	plilongigi ĉiudirekten
FADENO	longa maldika ŝnureto
FAJFI	krei sonon blovante tra la lipoj
FANTOMO	spirito de mortinto; reaperanto
FATALA	malfeliĉiga, grava, ne evitebla
FEBRO	forta eksciteco
FIRMA	neŝancelebla
FULMO	granda rapidpasanta ĉiela fajro
FURIO	furioza virino
HORIZONTO	limo de la vidkapablo
HURLI	bleki sovaĝe
INFERO	loko, kie mortintaj animoj suferegas
INSTINKTO	aŭtomata aktivigo, plejofte de bestoj
KALO	malmolaĵo de la haŭto
KANDIDATO	aspiranto al ofico
KAPRICO	subita, neantaŭvidebla emo
KARBO	nigra substanco, uzata por hejti
KNARI	eligi akran bruon skrapan aŭ frotan
KRAKI	eligi sekan bruon elŝirado aŭ rompado
LARĜA	multampleksa
LAZURO	blua koloro de la ĉielo
LEĜERA	malpeza
LULI	balanceti
LUPO	sovaĝa hundsimila besto
MANOVRI	fari laŭcelajn iradojn
MOKI	priridi iun
MUSKOLO	fibraĵo, kiu movas la membrojn de korpo
NEPRA	neevitebla, deviga
PALPI	tuŝesplori per la mano
PALPEBRO	membrano kovranta la okulon
PENI	energie streĉi siajn fortojn
PEPI	birdokrieti
PETOLI	amuziĝi infanece
PIPO	aparato, per kiu oni fumas tabakon
POŬPO	sipmalantaŭo
PRUO	ŝipantaŭo
PUPO	ludila figureto
RAMPI	antaŭeniri malfacile, foje surventre
REGIONO	speciala land- aŭ marspaco
REVI	imagi tion, kion oni forte deziras
REZONI	logike tiri konkludon el argumentoj
RIGIDA	nefleksebla
SALO	blanka substanco, uzata por gustigi manĝaĵojn
SAPO	substanco uzata por lavpurigi
SILKO	delikata teksaĵo
SIMIO	homosimila besto
SINO	homa brusto
SIRENO	marvirino kun fiŝa vosto
SOJLO	ŝtono aŭ trabo de enireja fundo
SOPIRI	ĝeme elspiri
SULKO	kavaĵeto
SVINGI	moveti ion rapide ĉiudirekten
ŜAŬMO	blankaĵo sur akvo aŭ alia fluaĵo
ŜELO	malmola ekstera krusto
TEMPESTO	ŝtormo
TRAJTO	karakterizaĵo
TUKO	peco de teksaĵo
VASTA	granddimensia
VELO	granda tuko fiksita por kapti la venton
VEZIKO	globeto
ALARMO	signalvoko
ASEKURI	kontrakti kontraŭ eventuala perdo
AUDIENCO	oficiala akcepto
BANDO	araĉo
BOMBO	eksplodaĵo
BOVO	kampara besto, kies ino donas lakton
DEMONO	diablo
EKSTERMI	tute detrui, neniigi
ELEFANTO	plej granda landbesto
FLOKO	malpeza peceto
FOJNO	sekigita herbo
FORMIKO	speco de insekto,tre laborema
GAJNI	akiri profite
GRENO	kreskaĵo, el kiu oni faras panon
GURDO	muzikilo, kiun oni funkciigas per turnilo
INCENDIO	brulego
INDULGI	trakti pardoneme
KAĈO	manĝaĵo el faruno, kun lakto aŭ akvo
KAPRO	barbhava kampara besto
KOMFORTO	ĉio, kio agrabligas la vivon
LAKTO	blanka fluaĵo de bovino
LAMENTI	plendadi ĝemante
MUŜO	fluginsekto
PLEDI	prezenti sian aferon antaŭ juĝisto
LOTI	decidi ion laŭ hazardo
LINO	kreskaĵo, el kiu oni faras tolon
PORKO	besto, kiun oni grasigas por manĝi
PROFESIO	okupo, per kiu oni vivtenas sin
PROVIANTO	provizoj de manĝaĵo
PRUNO	speco de frukto
PULO	parazita sudinsekto
SAKO	ujo el maldelikata ŝtofo
SEKALO	speco de greno
SEMI	disĵeti grajnojn sur la teron
STALO	bestloĝejo
STERKO	io uzata por plifekundigi la teron
SVARMI	amase kunestadi kaj moviĝi
SVATI	sin proponi al iu kiel edz(in)on
TABAKO	sekigitaj folioj, kiujn oni fumas
TASKO	difinita laboro
TERNI	brue kaj subite elspiri tra la nazo
ADEKVATA	egalvalora
ADEPTO	homo, kiu akceptis iun doktrinon
AGNOSKI	rekoni
AKTUALA	nuntempa
ANALIZI	esplori detale ion
APLIKI	uzi por speciala celo
ARGUMENTO	rezona pruvo
ARKAISMO	io malnoviĝinta
ASOCIO	grava societo
ATOMO	plej malgranda materiero
AVANGARDO	grupo, kiu iras la unua
BAZO	esenca principo
BREMSO	haltigilo
CIRKONSTANCO	fakto rilate iun situacion
DEDIĈI	plene fordoni al
DEFINITIVA	decida, finofara
DEKADENCO	iompostioma ruiniĝo
DEKLARACIO	oficiala anonco aŭ sciigo
DEMAGOGIO	popolekscita agado de potencavidaj politikistoj
DEMOKRATO	iu, kiu kredas priegalrajteco de ĉiuj homoj
DISKRIMINACIO	maljusta distingado
DISKUTI	interargumenti
DISTINGI	rimarki diferencon inter homoj aŭ ideoj
DIVERĜI	malproksimiĝi unu de la alia
DOKTRINO	akceptata principaro
EFEKTIVA	reale ekzistanta
EKONOMIO	administrada sistemo, ŝparado
EKSPLODI	diskrevi
EKZAKTA	severe preciza
ELITO	elektitaro
EMOCIO	kortuŝo
EVOLUI	disvolviĝi
FANATIKA	blinde fervora
FANTAZIO	kaprica imagado
FLAGO	simbola tolaĵo
FLEGI	prizorgi (ekz-e malsanulon)
GRAMATIKO	reguloj aŭ studado de iu lingvo
ĜENERALA	rilata al tutaĵo aŭ plimulto
HIMNO	religia kanto
ĤAOSO	kompleta ordomanko
IMPETI	antaŭenĵetiĝi
IMPULSO	ekpuŝo
INDIVIDUO	unuopa persono aŭ estaĵo
INERTA	senenergia, nemoviĝema
INFORMI	doni sciigojn aŭ klarigojn
INSIGNO	distingiga signo
INSTANCO	decidkapabla aŭtoritato
INVERSA	estanta en mala direkto
KALKULI	nombri, konsideri
KARAKTERIZI	montri ies karakteron
KLERA	instruita
KOALICIO	kunligo de diversaj interesoj por komuna celo
KOHERA	kunteniĝanta
KOMPLOTO	sekreta aranĝo por malicaj celoj
KOMPROMISO	interkonsento de konfliktaj interesoj
KONFLIKTO	aktiva malkonsento
KONKRETA	reale perceptebla, palpebla
KONTRIBUI	doni sian parton al komuna afero
KONVENCIO	akceptita moro
KONVINKI	akceptigi per pruvoj
KOREKTI	ĝustigi eraron
KRIBRI	apartigi pli delikatajn erojn
KRIZO	grave danĝera momento
KULTO	kvazaŭreligia adorado
LIMO	loko, kiu difinas la ekstremon de io
MEDIO	fizika aŭ spirita ĉirkaŭaĵo
MENSO	la spirita, nekorpa parto de homo
METODO	maniero atingi iun celon
MISTIKO	emo kredi je misteraj malklaraj kaj nepruveblaj kaŭzoj kaj efikoj
MODIFI	parte ŝanĝi
MONOLINGVISMO	doktrino pri unu komuna lingvo por ĉiuj
NEOLOGISM	nova vorto
NETA	nekonfuza kaj preciza
NIVELO	grado de alteco
NUTRI	doni manĝaĵon aŭ spiritan subtenon
OBJEKTIVA	senpartia
PACIENCO	eco trankvile atendadi
PARALELA	egaldistanca laŭlonge
PERCEPTI	koni per la sentorganoj
PERFEKTA	tute senmanka
PERIODO	difinita tempodaŭro
PESI	mezuri la pezon
PIONIRO	homo, kiu pretigas la vojon
PLANO	antaŭe decidita aranĝo por fari ion
POLILINGVISMO	plurlingvisma doktrino
PONTO	konstruaĵo por transiri super io
POTENCO	kapablo trudi sian aŭtoritaton
POZITIVA	nepre certa
PRAKTIKA	realigebla
PROGRESI	disvolviĝi antaŭen
PROJEKTO	proponata ideo
PROTOTIPO	la unua, laŭ kiu ĉiuj postaj kreiĝas
PROVIZORA	portempa
PULSO	korbatado
PUŜI	preme delokigi
RACIO	kapablo koncepti principojn
RASO	grupego da homoj samdevenaj
REKOMENDI	favore atentigi pri io
RELIEFO	atentiga distingeco
REVOLUCIO	subita grava ŝanĝiĝo
REZULTO	logika sekvo
ROLO	agado aŭ funkcio (ekz-e de aktoro)
RUTINO	kutimo, kiun oni daŭre kaj senpense ripetadas
SEKTO	aro da personoj aliĝintaj al stranga doktrino
SENTIMENTALA	havanta romantikan sentemon
SINONIMO	vorto samsignifa
SINTEZO	sistemiga rezonado
SKIZO	rapida desegno
SOLIDARA	respondeca ĉiuj pri la aliaj
STADIO	difinita grado de evoluo
STATI	esti en certa kondiĉo
STREBI	energie streĉi la fortojn
ŜANCELI	malfirmigi
TAKSI	difini la valoron de io
TAVOLO	parto de la socio konsiderata kompare kun pli superaj kaj pli malsuperaj partoj
TENDENCO	daŭra inklino al io
TEZO	scienca aserto
TRADICIO	ideo transdonita de pli fruaj generacioj
TRADUKI	transigi de unu lingvo en alian
TRENI	pene tiri post si
U.E.A.	Universala Esperanto Asocio
AKCELI	plirapidigi
AKURATA	ĝustatempa
AŬTOMOBILO	motorveturilo
BOTELO	vitra ujo
BROVO	hararo super la okulo
DEPRIMI	senkuraĝigi
DEVIZO	fremdmona ĉeko
DISTRI	agrable okupi
DUNGI	interkonsenti kun servisto por ricevi lian servadon
ENTREPRENI	komenci la plenumadon de grava tasko
ESTINGI	ĉesigi bruladon aŭ lumadon
EVENTUALA	povanta okazi
FOSFORESKI	lumi en mallumo
HOTELO	loĝejo por vojaĝantoj
INKO	kolora fluaĵo uzata por skribi
KAŬĈUKO	elasta gumo
KOMODO	tirkestaro
KONFIDENCO	sciigo, kiun oni konfidas, kaj kiu ne estu malkaŝota
KONSILI	sugesti farotaĵon
KONTO	komerca kalkulo
KONTURO	ĉirkaŭanta limlinio de io
KRUTA	preskaŭ vertikala
LIPO	buŝrando
LUI	havigi ion por provizora uzado, kontraŭ pago
NEPO	filo de fil(in)o
OBSEDI	premokupi la spiriton
PARALIZI	perdigi la movkapablon
PASPORTO	dokumento rajtiganta vojaĝi eksterlanden
PESTO	epidemia malsano
POLICO	administracio por prizorgi la publikan ordon
PREZO	vendvaloro de objekto
PROVINCO	la lando, ekster la ĉefurbo
RIFO	danĝera roko en la maro
SITUO	situacio
STAMPI	frapreliefigi markon
STARTI	ekiri
STRANDO	sabla marbordo
SUGESTI	proponi, subinspiri
SVELTA	ĉarme kaj elegante maldika
ŜALO	lantuko
ŜILDO	tabuleto surskribita
TAKSIO	aŭtomobilo luebla kun ŝoforo
TERASO	eksterdoma sidejo
TESTAMENTO	skribaĵo, per kiu oni difinas postlasaĵon postmortan
TRINKI	gluti fluaĵon
TRIUMFO	granda venko aŭ sukceso
VALIZO	kofreto
VELURO	mola ŝtofo
VIZIO	imagaĵo, iluzio
ABRUPTA	malagrable subita
ABSURDA	kontraŭa al la saĝo
ANALOGIO	io, kio estas parte simila
ASTRONOMO	homo, kiu studas la ĉielajn fenomenojn
ASTRONOMIO	studo de la ĉielaj fenomenoj
EFEKTO	forta impreso
EKSPANSIO	plietendiĝo
ENERGIO	laborkapabla forto
FIZIOLOGIO	scienco pri la funkcioj de vivantaj estaĵoj
FREKVENCO	nombro de periodoj en unu sekundo
GALAKSIO	stelamasego
GASO	aersimila fluidaĵo
GRAVITO	reciproka altiro de la korpoj
HEROLDO	diskoniganto
HIPOTEZO	provizore akceptata supozo
KEMIO	scienco pri la konsisto de materiaĵoj
KOMPETENTA	kapabla plenumi ion
KONSTELACIO	grupo da steloj
KOSMO	la tutaĵo de tio, kio ekzistas
LENSO	speciala vitrajo tra kiu oni pasigas la lumradiojn
MIKROSKOPO	instrumento por vidigi malgrandegaĵojn
MILIARDO	mil milionoj
NUDA	tute senvesta, nekovrita
PLANEDO	terbulo ĉirkaŭanta sunon
PRISMO	vitraĵo uzata por analizi lumkonsiston
REGISTRI	note enskribi
RELO	longa metalaĵo, sur kiu ruliĝas lokomotivoj ks
SPACO	senfinaĵo, en kiu moviĝas ĉiuj objektoj
SPEKTRO	vico da diversaj koloraj lumradioj
STABILA	neŝanĝiĝema, firma
ŜOVI	puŝe delokigi
TELESKOPO	instrumento por observi malproksimajn objektojn
TOTALA	ĉioma
UNIVERSO	la tuto de ĉio, kio ekzistas
VIBRI	moviĝi tien-reen rapide
ADMINISTRI	prizorgi la funkciadon de grava organizo
AFLIKTI	suferigi
BAMBUO	granda arbeca kano
BARKO	ŝipeto
BELETRO	belliteraturo
BONZO	budaisma pastro
BRANĈO	brako de arbo
BROKATO	teksaĵo ornamita per oraj aŭ arĝentaj fadenoj
BUBALO	speco de granda bovo
CIKONIO	granda longkrura birdo
DESTINI	antaŭfiksi la celon de io
DIAFANA	tralumebla sed netravidebla
DISTRIKTO	administra regiono
EKSTAZO	anima plezurego
FEO	supernatura fabela estaĵo
FENIKSO	fabela birdo kiu renaskiĝas el propra cindro
FLEKSI	kurbigi
FLOSI	resti sur akvo
FLUTO	tubeta muzikilo
FOLIO	maldika verdaĵero; maldika paperpeco k.s
FONTANO	akvoŝprucigilo
FREKVENTI	ofte vizitadi
GEMO	valorŝtono
GITARO	seskorda muzikilo
GRACIA	facilmova, belproporcia
GROTO	artefarita kaverno
HIRUNDO	speco de migrantabirdo
HONORI	trakti respekteme
ĤORO	kantistaro
JADO	verdkolora mineralo
KALENDARO	tabelo montranta la datojn
KATENO	ligĉeno por malliberuloj
KOMPENSI	repagi egalvalore
KONSOLI	mildigi ies ĉagrenon
KONSUMI	malrapide neniigi
KORIDORO	endoma trairejo
KOSTUMO	maniero sin vesti
KRISTALO	tre pura senkolora vitro
MAJESTA	imponaspekta
MANDARENO	altranga ĉina ŝtatoficisto
MUSKO	mola kreskaĵo sur rokoj kaj arboj
NOBELO	altranga persono
ORKESTRO	muzikistaro
PAGODO	templo de aziaj dioj
PAJLO	seka grentrunketo
PARFUMO	agrabla odoro
PENTRI	kolore desegni
PEONIO	speco de floro
PERSIKO	bongusta frukto
PILGRIMI	vojaĝi al sankta loko
PROKRASTI	lasi ĝis pli malfrue
RAVI	ĉarmegi, admirigi
REMI	movi upon per specialaj lignaj iloj
RIZO	nutrograjno kulturata en Azio
SALIKO	eleganta apudakva arbo
SANTALO	arbo kun bonodora ligno
SERPENTO	senpieda rampanta besto
SIGELO	stampilo
STALAGMITO	vertikale staranta rokpintaĵo en kaverno
STALAKTITO	pendanta rokpintaĵo en kaverno
TAPETO	murornamaĵo
TRONO	seĝo de reĝo
TUNIKO	speco de ĝisgenua ĉemizo
VEO	laments krio
VJETNAMIO	lando en sudorienta Azio
ABSOLUTA	senkondiĉa, senescepta, senmanka
AEROLITO	ŝtono falinta surteron el la spaco
AKUŜI	elpuŝi el si idon
AMBASADORO	oficiala reprezentanto de regno eksterlande
AMETISTO	violkolora gemo
AMONIAKO	gaso, NH3
ARMEO	granda militistaro
ARTO	homa kreado, plejofte reprezentanta iel belon
ASTRO	ĉiela korpo
AŬTENTIKA	nepre vera, originala; oficiale certigita
AVIADI	aerveturi
BEBO	infaneto, suĉinfano
BOLŜEVIKO	adepto de komunismo
BRODI	ornami teksajon per fadenaj desegnaĵoj
BUKLO	harvolvaĵo
CENZURI	oficiale kontroli presaĵojn k. a
ĈELO	malgranda konsistaĵero
DEBATO	diskuto laŭ orda maniero
DIAGRAMO	klariga desegno
DIPLOMATO	politikisto, kiu rilatas kun alilandaj registaroj
DRAKO	fabela besto havanta flugilojn kaj ungegojn
DRESI	celkonforme eduki (plejofte bestojn)
EBENA	samnivele plata
EFEMERA	nedaŭra, rapide pasanta
EKSPOZICIO	publika elmontriĝado
EPIDEMIO	disvastigita malsano
EPIZODO	unu flanks agado en rakonto aŭ historio
ESTETIKO	beltaksado
ETAĜO	samnivela parto de domo
FARTI	stati sane
FEKUNDA	fruktodona, naskipova
FELO	besthaŭto
FOKUSO	kunigpunkto de tralensaj lumradioj
FRAZO	vortkunaĵo; parolo belsona sed malmultsenca
FUTBALO	ludo, en kiu oni batas pilkon per la piedoj
FUNGO	speco de kreskaĵo foje manĝebla, foje venena
GENERALO	armeestro
GRAFIKO	arto desegne reprezenti objektojn
GRUNDO	kulturebla tero
HAJLO	glaciiĝinta pluvo
HIDROGENO	senkolora malpezagaso (H)
HOSPITALO	kuracejo
JUPO	virina vesto por la malsupra korpoparto
KANONO	pafilego
KAPITALO	profitodona ricaĵo
KARIKATURO	troigita kvazaŭportreto
KIRLI	rondirigi fluaĵon
KOBALTO	metalo (Co), kies kombinaĵoj blukoloras
KOLONIO	grupo da homoj loĝantaj konstante en lando fremda
KOMENTI	klarigi la signifon de io
KONTRAKTI	interŝanĝi skribitajn promesojn pri io komunue plenumota
KVARCO	tre malmola ŝtono
LABORATORIO	scienca laborejo
LAFO	materio, kiu elfluas el vulkanoj
LAKO	briliga ŝmiraĵo
LERTA	tre kapabla
LOGI	tente altiri
MAJUSKLO	ĉeflitero, granda preslitero
MAMO	elstara brustparto, kiu ĉe inoj donas lakton
MAPO	geografia karto
MARSO	la kvara planedo de nia suno; militodio
MASO	kvanto da materio konsistiganta iun korpon
MERLO	speco de birdo
METIO	manlabora profesio
MINERALO	substanco, kiu estas nek besta nek vegetaĵa
MINISTERIO	ministrejo
MODO	aktuala kutimo rilate vestojn ks
MURDI	krime mortigi
NITROGENO	senkolora gaso (N)
NODO	ŝnurkunligaĵo
OKSIGENO	senkolora gaso (O), necesa por spirado
OPRESI	tirane premegi
ORBITO	vojo de unu astro ĉirkaŭ alian
ORDENO	honora signo
PACIFIKO	la oceano inter Ameriko kaj Azio
PAPO	estro de la katolika eklezio
PERFIDI	mallojale trompi
PERTURBO	malordo en korpo, socio, ks
PLANTI	meti vegetaĵon en la teron por ke ĝi kresku
PLATA	senreliefa
POLIOMJELITO	speco de epidemia malsano
PROBABLA	verŝajna
RIBELI	rifuzi obeon
RITMO	perioda reveno de akcentoj
SAGO	akrapinta pafaĵo
SATELITO	korpo, kiu ĉirkaŭiras planedon
SEKURA	estanta en sendanĝera loko
SKALPO	haŭto sur la kaposupro
SLOGANO	konciza propaganda frazo
SMERALDO	verdkolora gemo
SPEKTROSKOPO	ilo, per kiu oni studas spektron
SPIONO	homo, kiu sekrete observas
STATISTIKO	cifertabeloj pri iu temo
STERILA	nekapabla naski
STILO	karakteriza maniero esprimi siajn pensojn aŭ fari ion
STRIKO	ĉeso de laboro por subteni iun postulon
STRIKTA	severe preciza
STRONCIO	flava metalo
STURMI	kurataki
ŜALTI	funkciigi elektron
ŜIKA	laŭmode bongusta
ŜTATO	regno
ŜUTI	verŝi substancon nefluidan
TANKO	milita aŭtomobilego
TEMPERATURO	grado de varmo
TERITORIO	difinita lando sub iu aŭtoritato
UNGO	malmola kreskaĵo sur fingropinto
URANIO	kemia elemento (U)
VAKUO	malplena spaco
VARBI	instigi al aligo
VARII	prezenti sinsekvajn diversajn ŝanĝigojn
VERMO	malgranda senpieda besto
VOLBO	arkforma plafono
VUNDI	difekti korpon
ALEO	(ĉi tie) mallarĝa trapasejo
ALUDI	nerekte paroli pri io
AMBOSO	feraĵo, sur kiu oni batas metalon
AVIZO	anonco, informo
BALONO	kaucuka ludilo, kiun oni plenigas per aero aŭ malpeza gaso
BAZARO	vendejo
BLAGO	ŝerca mensogo
BOJI	hunde bleki
BUDO	ligna butiketo
CIRKO	rondforma spektaklejo
DISPUTI	malpace diskuti
EKSKLUZIVA	esceptanta ĉion alian
EKZORCI	preĝe forpeli diablon
ESKAPI	sukcese forkuri aŭ eviti
FARSO	neserioza teatraĵeto
FASKO	kunligita aro
FAŬKO	besta buŝego
FILANTROPO	bonfaremulo
FORMATO	dimensio de libro (k.s.)
FUNEBRO	malĝoja sento pro ies morto
GALIMATIO	sensencaĵo, konfuzaĵo
GORĜO	interno de la kolo
HISTERIO	konvulsia nerva malsano
IDIOTO	homo malinteligenta
INICIATNO	entreprenemo
JUKI	kaŭzi malagrablan senton en la haŭto
KALSONO	subpantaloneto
KORNO	malmola kapelstaraĵo
KRETENO	malspritegulo
KRIĈI	alte kaj are krii
KUNIKLO	malgranda rapidkura longorela besto
KVAKI	bleki kiel ekz. rano
LEONO	granda kateca rabobesto
MAGIO	arto fari mirindaĵojn
MANDATO	rajtigilo
MARTELO	peza batilo
MURMURI	aŭdigi malfortan obtuzan bruon
NEGOCO	monprofita afero
OFERTI	komerce proponi
OPORTUNA	facile uzebla; bone adaptita por sia celo
PAKI	pretigi ion por transportado
PANIKO	subita ektimego
PAPILIO	bela grandflugila insekto
PIA	religie respektema
PRUNTI	disponigi aŭ akcepti ion poste redonotan
PSEŬDA	falsa, nur ŝajna
PUFA	plenblovita; plenŝtopita
PUNDO	brita monunuo
REDUKTI	dimensie malgrandiĝi
REMBURI	pufigi, enŝtopante ion
RITO	religia ceremonio
SARKASMO	akra moko
SKLAVO	homo senkondice je dispono de iu mastro
SPONGO	malpeza truplena materio, uzata por viŝi aŭ sorbi
STANDO	montrejo en ekspozicio
SVENI	perdi momente la konscion
ŜARĜI	meti pezan objekton sur ion
ŜRUMPI	malŝveli, malkreski
ŜTOPI	tute pleniĝi
ŜULDI	devi laŭleĝe pagi iun sumon
TUSI	spasme elpuŝi aeron el la pulmoj
URTIKO	vegetaĵo, kies folioj estas kovritaj de pikiletoj
VAMPIRO	sangosuĉa fabela monstro
VARO	komercaĵo
VIANDO	karno uzata por nutrado
VOLVI	ĉirkaŭmeti ion flekseblan ĉirkaŭ alian objekton
(GELT)	neesperanta vorto, slange uzita = mono
(ZO'O)	slanga mallongigo = best ĝardeno
ABOMENI	malamegi
AKORDO	sameco de opinioj inter pluraj personoj
ANĜELO	ĉiela di-servanto
BENKO	longforma sidilo
BURĜONO	ŝvelaĵo sur vegetaĵo, el kiu formiĝas folioj aŭ floroj
FIRMAMENTO	ĉiela arkaĵo
IMPLIKI	malorde ĉirkaŭvolviĝi
INDIGNI	senti koleron kaj malestimon
KAJTO	fluganta infanludilo
KRABO	manĝebla marestaĵo kun du pinĉilegoj
KVADRATO	ortangulajo, kies kvar linioj estas samlongaj
MILDA	malsevera
OSTO	malmola substanco, kiu formas skeleton
PAPERO	folio, sur kiu oni skribas
PEKINO	la ĉefurbo de Ĉinujo
PERSEKUTI	konstante turmenti
PLUMBO	tre peza, griza metalo
RIVALO	konkuranto
SKELETO	interna malmolaĵo, bazo de la homo aŭ besto
SKOLOPENDRO	multpieda ringforma krablanta insekto
TABULO	plata longa peco da ligno
TABURETO	sendorsa seĝeto
TEGOLO	maldika plataĵo, per kiaj oni kovras tegmentojn
APARTA	malkuna, disigita de
ATRIBUI	destini; aljugi
BARIO	arĝentblanka metalo
BIOLOGIO	scienco pri la fenomenoj de la vivo
BISMUTO	flavblanka metalo
CIVILIZI	socie kulturi
DISERTACIO	verko traktanta pri scienca aŭ literatura temo
DOKTORO	plej alta universitata diplomo
EFIKI	havi rezulton
EKSPLIKI	klarigi kaj komprenigi ion
ERAO	difinita epoko
ERCO	neprilaborita metalo
FAKULTATO	fako de universitato
FASCINI	nerezisteble allogi
FORMULO	preciza dirformo
HELIUMO	unu el la kemiajelementoj (He)
INDUSTRIO	produktado de riĉaĵoj
INICIATI	esti la unua, kiu proponas aŭ faras ion novan
INSTITUTO	nomo de scienca aŭ artista altlernejo
INTUICIO	kvazaŭinstinkta kono
IRONIO	moka dirmaniero
IZOTOPO	atomo de elemento,kies atompezo diferencas
JONO	atomo, kiu gajnis aŭ perdis elektronojn
JONIZI	produkti jonojn
KALIO	unu el la kemiaj elementoj (K)
KATEDRO	profesora seĝo
KLIŜO	fotografia negativo
KOMPONI	harmonie aranĝi;kunigi la kemiajn elementojn de io
KONDIĈO	cirkonstanco de kiu dependas efektiviĝo
KORTO	spaco ĉirkaŭita de konstruoj aŭ muroj
KUPRO	brunruĝa peza metalo(Cu)
KURENTO	fluo de elektro
LAVANGO	falanta neĝamasego
LICENCIO	universitata rango
LISTO	serio de nomoj
LONDONO	la ĉefurbo de Britujo
MAKROKOSMO	la tuta universo
MANSARDO	subtegmenta ĉambro
MATERIO	perceptebla substanco
MEDALO	metala honoriga disko,stampita ambaŭflanke
MEDICINO	scienco pri sano kaj malsano
MIKROKOSMO	malgranda universo; modelo de 1a universo
MODELO	malgranda kopiaĵo de io
MOLEKULO	plej malgranda ero de kemia korpo
NUKLEO	atomkerno
OMAĜI	fari honoron al iu
PARIZO	la ĉefurbo de Francujo
PERSPEKTIVO	aspekto de io malproksima
POLA	rilata al Pollando
PRECEDENCO	pasintaĵo, kiu pravigas nunan agadon
PROFESORO	fakestro en universitato
RADIKALA	ĝisfunda, esenca
RADIOLOGIO	scienco pri radiokrea energio
RANGO	grado de graveco de iu
SOLDATO	nmilitisto
SORBONO	la universitato en Parizo
SPONTANA	propravola; ekestanta sen ekstera influo
STRUKTURO	kunaranĝo de diversaj partoj de tutaĵo
SUBSTANCO	ĉiu speco de materio
TERAPIO	arto kuraci
TITOLO	nomo montranta rangon
TORIO	unu el la kemiaj elementoj (Th)
TRAFIKO	ĉirkaŭirado sur vojoj
TRAGIKA	terure malfeliĉa
TUMORO	malsaneca ĉelaro kreskanta en organismo
VARSOVIO	la ĉefurbo de Pollando
AKTORO	teatra ludisto
ALMOZO	monhelpo al malriĉulo
ANEKDOTO	mallonga sprita rakonto
APLAŬDI	montri aprobon
ARTIFIKO	trompa ruzaĵo
BENGALA	rilata al Bengalujo, orienta regiono de Hindujo
CIGANO	homo el vaganta hindujdevena gento
CIVITO	tutaĵo de la regnanoj
DIREKTORO	direktisto de ofico
DORNO	pikileto de vegetaĵo
EVIDENTA	klara kaj senduba
FILISTRO	senidealulo, vulgarulo
GRATULI	esprimi al iu kontentecon pri iu lia sukceso
ĜEMI	aŭdigi plendan brueton
ILUZIO	erara penso aŭ opinio
IMITI	similigi sin aŭ ion al io aŭ iu alia
INFEKTI	havigi al iu malsanon
INKLUZIVA	enhavanta en si
INSTRUMENTO	speciala ilo; ĉi tie: muzikilo
JAGUARO	amerika katsimila rabobesto
KOLOMBO	birdo kun forta hejmiga instinkto
KOLUBRO	nedanĝera serpento
KOMPROMITI	endanĝerigi
KONFERANSEO	programestro
KONKLUDO	fino de rezonado; finrezulto
KORBO	portebla ujo farita el sekaj herbaĵoj ks
KRAVATO	ornama rubandaĵo, kiun viroj portas ĉirkaŭ la kolo
KROĈI	ligi per hoko
LEVO	bulgara monunuo
MANTELO	longa supervesto
MIKROFONO	instrumento, kiu plilaŭtigas sonojn
MORDI	ŝiri per la dentoj
MUSO	malgranda malutila besto
NEGLEKTI	malzorgi, malatenti
ORIGINALA	ne simila al aliaj
POPO	grekortodoksa pastro
PROGRAMO	la enhavo de teatraĵo ks
PRONONCI	aŭdigi klare
PROTESTI	fari deklaron kontraŭ io
RATO	malutila besteto
REKVIZITO	teatra ekipo
TELEGRAMO	komuniko rapide transsendata
TELERO	malprofunda manĝovazo
TIGRO	granda katsimila rabobesto
TIKLI	delikate kaj ridige tuŝeti iun
TRETI	piedpremi
TUMULTO	konfuza brua malordego
VOSTO	postpenda hararo de besto
AŬTONOMIO	politika sendependeco
FIBRO	kunplektitaj korpaj aŭ vegetaĵaj fadenoj
FORTIKA	malfacile rompebla
IZOLI	apartigi de la aliaj
KALUMNII	malutili al iu per mensogaj akuzoj
LITOVUJO	provinco en tiama rusia Pollando
MORO	ĝenerala vivmaniero. kutima konduto
MOTIVO	kialo
ORATORO	homo, kiu publike paroladas
PREDIKI	fari religian aŭ kvazaŭreligian paroladon
RUSA	rilata al Ruslando
ŜOVINISTO	fanatika patrioto
TEORIO	supozo rezulte de rezonado
AKRO	unuo de termezuro
ARABO	nordafrikulo
ARDI	esti varmega
AZENO	kvarpieda longorela ŝarĝbesto
BIENO	terposedaĵo
CEREMONIO	formala ĝentileco
ĈARMA	delikate plaĉa kaj loga
DAKTILO	speco de frukto
DIGNO	memrespekto
DROMEDARO	unuĝiba besto, kiun oni rajdas en dezerto
DUNO	sabla monteto
EKIPI	provizi iun per necesaj iloj
FESTENO	luksa kaj abunda manĝo
FRIPONO	ruza malhonestulo
FRIVOLA	malserioza
GAZELO	svelta rapidkura besto
GRAVEDA	portanta naskotan idon
GRIO	senŝeligitaj grajnogrenoj
HORDEO	grenspeco
INSIDI	prepari por trompi iun
INSTALI	starigi kaj funkciigi ion
ITALA	rilata al Italujo
JUDO	viro de la hebrea gento
KANAJLO	malnobla homo
KOKETA	ornamama kaj flirtema
KRAĈI	elĵeti salivon el la buŝo
MAGNEZIO	kemia elemento(Mg)
MAHOMETANO	religia sekvanto de Mahometo
MAJORO	oficira armea rango
MALVO	rozviola floro
MEHARISTO	araba soldato rajdanta sur dromedaro nomata mehari
MENTO	aroma vegetaĵo
NEGRO	nigrulo
NIMFO	virina diaĵo de akvo, arbaro kaj monto
NOMADO	migrulo
OAZO	fekunda insulo en la dezerto
OKRO	speco de mineralo uzata kiel farbo
ORIGINO	devenloko
PALMO	varmlanda arbo
PAPRIKO	ruĝa pipro
RAJDI	sidi sur dorso de besto
REPUTACIO	publika opinio pri iu
REZERVI	konservi por iu destino
RIVERO	granda akvofluo
RUKTI	brue eligi stomakgasojn tra la buŝo
SALOMONO	biblia reĝo konata kiel lerta juĝisto
SAŬCO	spica manĝfluaĵo
SKABIO	infekta haŭtmalsano
SORBI	enspirante altiri fluaĵon iom post iom en sian buŝon
STUFI	longe kuiri viandon en fermita kaserolo
SUDANA	rilata al Sudano
SUKO	nutra fluaĵo
ŜUO	piedvesto
TAKTO	kapablo ĉiam agi kun ĝentileco kaj delikateco
TEO	trinkaĵo farita el sekigitaj folioj
TONO	nuanco de sono aŭ koloro
TRIBO	grupo de homoj samdevenaj
VEGETI	vivi inerte
VENKI	superi malamikon
VIRTO	konstanta emo fari bonon
VERDIKTO	decido de juĝanto
AŬDACI	maltimi
BALADO	rakonta poeziaĵo
BANDAĜO	longa tolaĵo por kovri vundon
BASO	plej malalta vira voĉo
BLEKI	krii kiel besto
BUBO	petola knabeto
ĈEVALO	kvarpieda rajdbesto
GLORO	famo kaj honoro
GRIMACO	tordiĝo de la vizaĝo
ĴALUZA	timanta pri perdo de kara objekto
KAPONO	kastrita koko, kiun oni manĝas
KAPREOLO	cervosimila besto
LEOPARDO	afrika katsimila rabobesto
LIMAKO	ĝardena rampuleto
MASAĜI	kurace premfroti la muskolojn
MIRAĜO	erariga alloga iluzio
PANTOFLO	hejma piedvesto
PAVO	birdo kun granda bela vosto
RIMO	versfina samsoneco
RUBANDO	longa mallarĝa teksaĵo
SENTENCO	mallonga frazo en havanta ĝeneralan moralan principon
SOPRANO	plej alta virina voĉo
TAMBURO	muzikilo, kiun oni batas per bastonoj
VARTI	zorgi infaneton
VILA	kovrita per densaj mallongaj haroj
ABIO	konifera arbo
ACERO	speco de arbo
AGRIMONIO	speco do herbo
AKTIVA	agema
ALISMO (PLANTAGA)	speco de herbeca marĉoplanto
ASIGNI	destini, disponigi
ASPERULO	speoo de floro
BALZAMINO	speco de planto
BERO	frukto de diversaj plantoj
BETULO	blankligna arbo
BLUZO	vesto por la supra korpo parto
CITIZO	arbo kun flavaj floroj
ĈERIZO	ruĝkolora bongusta frukto
EKSKREMENTO	tiu parto de la nutraĵo, kiun oni poste eligas el la korpo
EMBUSKO	sinkaŝo por surprize ataki malamikon
ERIKO	arbeto kun rozaj aŭ blankaj floroj
FAKTORO	kaŭzo de fenomeno
FRAGILA	tiel delikata ke ĝi facile rompiĝus
FRAGMITO	speco de fortika herbo
FRAKCIO	ono
FRAKSENO	arbo kun fleksebla ligno
FURAĜO	manĝajo por bestoj
GALIO	speco de planto
GRAJNO	malgranda semo
ĜEMELO	dunaskito
ĜERMO	komenca formo de estonta vegetaĵo aŭ besto
HAKI	battranĉi
HEKTARO	unuo do termezurado
HOKO	pinta ferkurbaĵo
HORTIKULTURO	la metio kulturi plantojn
HUMO	nigrebruna tern uzata kiel sterko
INFLORESKO	la aranĝo de floroj sur tigo
INVADI	perforte eniri kaj okupi
KAMECIPARIDO	konifera arbo
KAMENO	fajrujo
KONFETOJ	karnavalaj paperpecetoj
KAPSULO	skatoletforma ujo
KONIKO	duaorda kurbo
KUKO	franda bakaĵo
LANUGO	delikata plumaro aŭ hararo
LAPO	speco de planto
MANAO	ĉiela nutraĵo
MEJLO	mezuro de distanoo
METRO	mezuro por linioj
MIGRI	translokiĝi de loko al loko
MIRTELO	speco de arbeto
NUKSO	frukto en malmola ŝelo
ODISEO	heroo de greka poem, kiu dek jarojn vagadis tra la mondo
OMBRELO	kontraŭpluva ŝirmilo
OVO	maturiĝonta bestĝermo en ŝelo
PARAŜUTO	aparato por malrapide fali tra la aero
PARKO	publika plezurkampo
PASERO	birdspeco
PELTO	speciale preparita felo
PICEO	konifera arbo
PINO	konifera arbo
PIRO	bongusta frukto
PLANTAGO	ofta plurjara herbo
PLUGI	tranĉi la teron per speciala kulturilo
PLUKI	deŝiri floron
POTO	speco de vazo
PRIMOLO	printempa floro
RADIKO	subtera parto de vegetaĵo, per kiu ĝi alsuĉas nutraĵon
RETRO-	sufikso, kiu signifas “dorseniri”
RINGO	cirkloformaĵo
SKALO	dimensioj de desegnaĵo rilate al la reala objekto
SORPO	arbo, kies fruktojn oni manĝas tromaturajn
STURNO	speco de birdo
TAŬZI	ĉifante malordigi
TERENO	difinita terspaco
TIFAO	speco de marĉherbo
TIGO	flortrunketo
TORFO	spongeca substanco, per kiu oni povas hejti
TRIKI	teksi per vergetoj
TROPIKO	paralelo je 23°de la ekvatoro
TRUPO	soldataro
TUBO	long kava cilindro
TUJO	konifera arbo
ULMO	speco de fortika arbo
URSO	speco de granda rabobesto
VITAMINO	helpa nutrofaktoro necesa por la sano
AKVARIO	vitra akvujo en kiu estas fiŝoj
ANIMALO	vivanta estaĵo, sed ne vegetaĵo
AROGANTA	impertinenta, fieraĉa
BALAI	forpuŝi polvon aŭ malpuraĵon
BROSO	speciala ilo uzata por forigi malpuraĵon
DESERTO	lasta parto de manĝo
DISKO	metala ronda plataĵo uzata en ĵetludoj
DOTO	geedziĝa havaĵo
EKVILIBRO	egalpezeco
FALDI	refleksi ion maldikan, tiel ke unu parto kuŝas sur alia
FAZO	evolustadio
GAMBO	kruro
GRINCI	eligi malagrablan frotsonon
KADUKA	ruiniga
KARAMBOLI	kolizii
KASKO	soldata aŭ oficista kapŝirmilo
KLASIFIKI	aranĝi laŭ klasoj aŭ gradoj
KRISTO	laŭ la kristanoj, la Filo de Dio
KUGLO	konusforma metalaĵo, kiun oni ĵetas per pafilo
KULMINO	la plej alta punkto, la ekstremo
KVITANCO	ricevatesto
LEPORO	longorela besteto simila al kuniklo
LIKVORO	alkoholaĵo
MANIKO	parto de vesto, kiu kovras la brakon
MESO	katolika diservo
MOTOCIKLO	biciklo kun motoro
NOKAŭTI	senkonsciiĝi per bato
OPOZICIO	kontraŭstaro
PISTI	batpecetigi
PROCEDO	difinita agmaniero
PROKLAMI	oficiale kaj publike anonci
RIMENO	longa mallarĝa leda strio
STABO	armeestraro
STANGO	longa peco de ligno aŭ metalo
SUPO	manĝaĵo el akvo, en kiu oni kuiris viandon kaj legomojn
ŜOFORO	kondukisto de aŭtomobilo
ŜRANKO	meblo, en kiu oni pendigas vestojn aŭ konservas manĝaĵojn
TAĈMENTO	aro da homoj senditaj por speciala celo
TINTI	seke resoni
TRIBUNALO	juĝistaro
TROTUARO	apudvoja irejo por piedirantoj
AFRIKANSA	rilata al nederlanddevena lingvo parolata en Sudafriko
AGENTO	komisiito
AGRIKULTURO	terkulturado
AMERIKA	rilata al la termaso okcidente de Atlantiko
ARISTOKRATO	nobelo
BASTARDO	eksteredzeca infano
DEMOKRATIO	demokrataro
DEVII	devojiĝi
DILUI	maldensigi likvaĵon
EDINBURGO	la ĉefurbo de Skotlando
EKLEZIO	tuto de la anoj de iu kristana religio
FABLO	versrakonto en kiu bestoj aŭ objektoj rolas kiel homoj
FARMI	lui bienon por ĝin kulturi
GENERACIO	tuto de la samaĝaj homoj samtempe vivantaj
HINDUSTANA	rilata al lingvoparolata en Hindujo
HONESTA	konforma al honoro, virto kaj justeco
HUNGARA	rilata al Hugarujo
INTRIGI	ruze kombini por atingi ion
KONTINENTO	granda terdividaĵo
KULTIVI	kulturi la teron
MALICA	konscie malbonfarema
MENTORO	saĝa gvidanto
MERKATO	vendosfero
ORGOJLA	fierega
ORTODOKSA	konforma al tradicia doktrino
PAROĤO	eklezia distrikteto
SATIRO	verko, kiu kritike primokas ion aŭ iun
ŜAFO	lanprodukta besto
TEKSTO	enhavkonsisto de libro
TIRANO	senindulga kaj severa reganto
VERSIO	tradukvarianto
VOLUMO	unuopa libro
ABSOLVI	pardoni la pekojn
ADOPTI	alpreni iun kiel sian filon ad filinon
AKCIDENTO	malfeliĉa neatendita okazo
ANTROPOFAGO	hommanĝulo
AŬSPICIO	antaŭsigno pri estonteco
BREĈO	trarompaĵo
CIPRO	insulo mediteranea
DOĜO	estro de la venecia respubliko
FORTUNO	bona sorto
FRAGMENTO	derompita peceto
GALO	maldolĉa hepatsuko
GENERI	naskigi
GLAVO	pikbatalilo
IMUNA	ŝirmata, netuŝata
KANIBALO	hommanĝulo
KAVERNO	natura subtera kavo
KONFORMA	samforma
KORNEDO	standardisto
MANIFESTI	evidentigi
MAŬRO	nigrulo el nordafriko
POVRA	kompatinda; malriĉa
SIEĜI	ĉirkaŭi fortikaĵon por ĝin kapti
SPITI	kontraŭstari la volon de iu alia
SUSPIRI	sopirĝemi, vespiri
TREZORO	valoraĵo
TURKA	rilata al Turkujo
ABSCESO	pusamaso
ABUNDA	grandkvanta
ACIDA	akragusta
ALUMETO	ekbruliga lignopeco
AMELO	substanco uzata por rigidigi tolaĵon
ANGIO	korpa tubo, tra kiu fluas sango
ARGILO	glueca tero
BELGA	rilata al Belgujo
BULO	globforma peco de materialo
BUTONO	vestkuntenilo
DRATO	metalfadeno
DURA	malmola
EPITETO	kvalitiga adjektivo
FARĈO	viandpecetoj, kiujn oni enmetas internen de manĝaĵo
FAVO	parazita kaphaŭta malsano
FEKI	eligi ekskrementon
FERMENTO	organika substanco, kiu kaŭzas malkomponiĝon
FIGO	dolĉa mola frukto
FILOKSERO	tre malgranda insekto
FLARI	percepti per la nazo
FOSI	fari kavaĵon en la tero
KAPOTO	granda dika mantelo
KEGLO	ligna staraĵo, kiun oni renversas per pilko
KOLO	korpoparto inter kapo kaj trunko
KONKERI	militakiri
KORPULENTA	dikventra
KORPUSO	granda armedividaĵo
KRISPA	neregule ondeta
KRUĈO	speco de vazo kun tenilo
KUDRI	kunligi per fadeno
KVODLIBETO	muzikaĵo diversspeca kaj varia
LANO	ŝafhararo
LEŬTENANTO	oficiro sub kapitano
MAGAZENO	luksa butiko
MEKANIKA	farata per maŝino
OBUSO	kuglego
ORANĜERIO	varma halo por konservi arbojn dumvintre
ORFO	knabo, kies patro aŭ patrino mortis
-OZ	sufkso signifanta plena de, riĉa je
PINĈI	premi inter du fingroj
POMERIO	germana provinco
PRINCO	reĝido
PROVENCO	suda regiono de Francujo
PUTRI	malkomponiĝi
REGIMENTO	parto de armeo
RENDEVUO	interkonsentita renkontigo
RESPUBLIKO	reĝimo, en kiu regas popolaj reprezentantoj
RIKOLTI	detranĉi kaj kolekti, ekz-e grenon
RODI	mordeti
RUBO	senvaloraĵoj, forĵetindaĵoj
SILIKO	malmola ŝtono, per kiu oni povas fari fajron
SOLDO	malgranda monero
SPIKO	vico de grajoj sur tigo
STRANGOLI	sufokpremi la gorĝon de iu
SULFURO	flava materialo trovebla de vulkanoj
ŜMACI	kisi aŭ manĝi brue
TAVERNO	trinkejo
TRANĈEO	protekta fosaĵo
TRISTA	malĝoja
VENTRO	meza parto de la korpo
VINO	alkohola trinkaĵo
VITO	vinberarbeto
VERTAGO	speco de hundo kun mallongaj kruroj
AGORDI	emigi iun al io
AKVOPOLOO	pilkludo en naĝejo
ALIANCO	interligo
ALTARO	rita tablo por religiaj oferoj
ANĈOVO	speco de fiŝeto
ANONCI	antaŭsciigi
ANSO	kurba tenilo
ARENO	loko en la centro de cirko por bataloj kaj ludoj
BAGO	valizo
BANTO	ornama nodo
BARBITURATO	speco de drogo
BASENO	akvujo en ĝardeno
BIKINI-KOSTUMO	tre eta dupeca naĝkostumo
BOMBONO	sukeraĵo
BRETO	horizontala tabulo por surmeti objektojn
BRUTO	kvarpieda paŝtobesto
BUDAPEŜTO	la ĉefurbo de Hungarujo
BUĜETO	la sumo de la jaraj en- kaj el-spezoj
BUKEDO	kunligaĵo de detranĉitaj floroj
BURĜO	mezklasulo
ĈAMPANO	speco de saŭmvino
ĈERKO	kesto, en kiun oni metas kadavron
DIGO	akvobarilo
EKSTRA	plia, aldonita
EVENTO	grava okazaĵo
FANDI	fluecigi per varmo
FARBO	koloriga substanco
GALONO	dika rubando por ornami aŭ borderi veston
GIMNAZIO	mezgrada lernejo
GRANDIOZA	impone granda
GRATI	froti per la ungoj
GVATI	kaŝe aŭ deĵore observi
HENI	ĉevalbleki
HEPATO	granda glando, kiu produktas galon
HUMIDA	malseka
HUŜI	fortimigi birdojn, kriante “Hug!”
IMPROVIZI	fari ion senprepare
INCITI	koleretigi
JUNGI	alligi beston al tirota veturilo
JURO	leĝoscienco
KANAPO	longa apogseĝo
KAPACITO	la kvanto, kiun ujo povas enteni
KAZINO	konstruaĵo por publikaj amuzaĵoj 
KLAKI	eligi mallongan sonon per rapida movo de io kontraŭ io
KOINCIDI	okazi en la sama momento
KOLĤOZO	mastruma kolektivo
KOLONJO	urbo en Germanujo
KOMPOTO	manĝaĵo farita el fruktoj kuiritaj kun sukero
KONEKSA	interligita
KONKO	kalka tegaĵo de moluskoj
KOTLETO	rostita viandpeco
KRANIO	tutaĵo de la ostoj entenantaj la cerbon
KREZO	tre riĉa homo en la antikva tempo
KULERO	manĝilo per kiu oni ĉerpas
KUSENO	remburita sako por la kap-apogo
LADO	metala plato
LAMA	malfacile paŝanta pro kripleco
LAMPIONO	lampeto
LATINO	la lingvo de la Romianoj
LEKI	tuŝi per la lango
MAGAZINO	perioda revuo
MAJSTRO	titolo donata al homo fake elstare kompetenta
MASKO	artefarita vizaĝo, vizaĝkaŝilo
MATĈO	ludo aranĝita inter du trupoj
MATRIKULO	listo de anoj
MELODIO	belsona muzikaĵo
MELONO	granda sukplena frukto
MENTONO	vizaĝparto sub la buŝo
MIRTO	arbeto kun ĉiamverdaj folioj
MUZELO	elstara ĉirkaŭbuŝa kapoparto de bestoj
NORMO	modelo de la ordinara tipo aŭ kutimo
NUKO	posta parto de la kolo
NUPTO	geedziĝo
OBSTINA	firme necedema
OBTUZA	malklara, kvazaŭ sufokata
OCEANIO	la tuto de la pacifikaj landoj
OLDA	maljuna, malnova
PANTALONO	dukrura vesto por la suba korpoduono
PEDANTA	precize kaj detale zorganta pri malgravaĵoj
PEKI	malobservi moralan leĝon
POLEKSO	dikfingro de la mano
PULOVERO	trikita torsovesto
RANCA	ricevinta malagrablan odoron pro malkomponiĝo
RAPORTI	sciigi tion, kion oni vidis aŭ faris
RASPI	skrapi per speciala ilo
REPRODO	(mallongigo) = reproduktaĵo
REZOLUTA	decidema, firmanima
SCIURO	malgranda besto vivanta en arboj
SKRUPULO	dubo de konscienco
STATUO	homsimilaĵo el ŝtono
ŜMINKI	ŝmiri la vizaĝon per kolorilo
TAPIŜO	teksita plankokovrilo
TEGI	kovri ion tiel, ke la kovro kaj la kovritaĵo unuiĝas
TELE-	prefikso, kiu signifas “en malproksimo”
TELEFONO	aparato por interparoli tra granda distanco
TENTI	instigi al io malpermesita
TREMOLO	speco de arbo
TROGLODITO	kavernulo
TUALETO	necesaĵoj por sin vestado
TUĈI	skrbi per speciala nigrega inko
TURISTO	homo vojaganta por plezuro
ULTIMATO	lasta averto antaŭ milito
VAZO	ujo
VENENO	vivdetrua substanco
VISKIO	skota brando
ZIZELO	malgranda mambesto, kiu dormas dum la vintro
TRANKVI	(mallongigo) = trankviligi